11111111111111111111111111111111
11............................11
1.....P........................1
1..............................1
1......1...1..111...1...1......1
1.......1.1..1...1..1...1......1
1........1...1...1..1...1......1
1........1...1...1..1...1......1
1........1....111....111.......1
1..............................1
1....1.......1..1..11...1......1
1....1...1...1..1..1.1..1......1
1....1..1.1..1..1..1..1.1......1
1....111...1.1..1..1...11......1
1....1......1...1..1....1......1
1..............................1
1.........1.....1..............1
1.........1.....1..............1
1...1.....1.....1....1.........1
1....1..............1..........1
1.....11111111111111...........1
1..............................1
11............................11
11111111111111111111111111111111